the-house-of-the-devil	Horror,Short
la-belle-et-la-bete	Family,Fantasy,Romance
sleeping-beauty	Drama,Fantasy,Short
alice-in-wonderland	Fantasy,Short
hamlet	Drama,Short
othello	Drama,Music,Romance
macbeth	Drama,Short
les-miserables	Drama,History,Short
faust	Drama,Short
frankenstein	Fantasy,Horror,Sci-Fi
sisters	Drama,Short
the-last-of-the-mohicans	Adventure,Short
the-scarlet-letter	Drama,Short
eva	Drama
the-artist	Animation,Short
dead-mans-shoes	Drama,Short
milk	Animation,Short
rebecca	Drama,Short
anna-karenina	Drama
the-beast	Drama,Short
the-forbidden-room	Drama,Short
happy-go-lucky	Comedy,Drama,Short
the-intruder	Drama,Romance,Short
jane-eyre	Drama
lola	Drama
the-lure	Drama
mother	Drama,Short
the-ring	Drama,Short
too-late	Drama
business-is-business	Drama
by-the-sea	Comedy,Short
the-criminal	Drama,Short
the-great-silence	Drama,Short
the-immigrant	Drama
scandal	Drama
the-wolf-man	Drama
the-woman-next-door	Drama
youth	Drama,Short
destiny	Drama,Short
help	Comedy,Short
judex	Adventure,Crime
sunshine	Comedy,Short
the-witch	Drama
great-expectations	Drama
thirst	Comedy,Short
the-claim	Drama
the-house-of-mirth	Drama
revenge	Western
salome	Drama
the-stranger	Comedy,Short,Western
atonement	Drama,Romance
broken-blossoms	Drama,Romance
deliverance	Biography,Drama
the-cabinet-of-dr-caligari	Fantasy,Horror,Mystery
the-third-generation	Drama
wuthering-heights	Drama
the-fighter	Drama
high-heels	Drama
jackie	Drama,Romance
the-kid	Comedy,Drama,Family
shame	Drama
haxan	Fantasy,History,Horror
nosferatu	Fantasy,Horror
coeur-fidele	Drama,Romance
the-fog	Drama
innocence	Drama
the-wheel-la-roue	Drama
manhattan	Adventure,Comedy,Romance
before-midnight	Drama
battleship-potemkin	Drama,History,Thriller
the-gold-rush	Adventure,Comedy,Drama
the-phantom-of-the-opera	Horror
the-verdict	Mystery
the-wizard-of-oz	Adventure,Comedy,Family
the-boy-friend	Comedy,Romance
the-holy-mountain	Drama
the-magician	Drama,Fantasy,Horror
metropolis	Drama,Sci-Fi
the-american	Western
black-jack	Action,Romance,Western
cabaret	Crime,Drama
chicago	Comedy,Crime,Drama
it	Comedy,Romance
new-york-new-york	Drama
open-range	Western
turkish-delight	Comedy
underworld	Crime,Drama,Film-Noir
wings	Action,Drama,Romance
pandoras-box	Crime,Drama,Romance
the-docks-of-new-york	Crime,Drama,Film-Noir
dressed-to-kill	Comedy,Crime
the-last-command	Drama,History,Romance
the-man-who-laughs	Drama,Horror,Mystery
moulin-rouge	Drama
the-passion-of-joan-of-arc	Biography,Drama,History
submarine	Action,Drama
underground	Drama,Romance
the-white-sheik	Adventure
the-aviator	Comedy
man-with-a-movie-camera	Documentary,Music
prisoners	Crime,Drama,Romance
the-river	Drama,Romance
the-sixth-sense	Drama
a-single-man	Comedy
stolen-kisses	Comedy,Romance
un-chien-andalou	Fantasy,Horror,Short
the-wolf-of-wall-street	Drama
42nd-street	Comedy,Short
the-big-trail	Adventure,Romance,Western
undertow	Drama,Romance
city-lights	Comedy,Drama,Romance
dracula	Fantasy,Horror
iron-man	Drama
m	Crime,Mystery,Thriller
the-maltese-falcon	Crime,Drama,Film-Noir
midnight-special	Drama
blonde-venus	Drama
freaks	Drama,Horror
life-is-beautiful	Romance
scarface	Action,Crime,Drama
shanghai-express	Adventure,Drama,Romance
vampyr	Fantasy,Horror
high-and-low	Comedy
island-of-lost-souls	Horror,Sci-Fi
king-kong	Adventure,Horror,Sci-Fi
queen-christina	Biography,Drama,History
black-moon	Drama,Horror
the-fountain	Drama,Romance
it-happened-one-night	Comedy,Romance
madame-bovary	Drama
the-man-who-knew-too-much	Crime,Mystery,Thriller
maniac	Horror
tenebre	Drama
white-heat	Drama,Romance
magnificent-obsession	Drama,Romance
a-night-at-the-opera	Comedy,Music,Musical
the-lower-depths	Crime,Drama,Romance
dont-look-now	Animation,Comedy,Family
martha	Musical
modern-times	Comedy,Drama,Family
sweeney-todd-the-demon-barber-of-fleet-street	Drama,Horror
swing-time	Comedy,Musical,Romance
things-to-come	Drama,Sci-Fi,War
the-adventures-of-robin-hood	Action,Adventure,Romance
youth-in-revolt	Adventure,Drama,Fantasy
boy-meets-girl	Comedy
fireworks	Comedy
gangs-of-new-york	Crime,Drama
marie-antoinette	Biography,Drama,History
frenzy	Comedy
gone-with-the-wind	Drama,History,Romance
some-like-it-hot	Comedy,Musical,Romance
young-mr-lincoln	Biography,Drama,History
the-grapes-of-wrath	Drama,History
the-great-dictator	Comedy,Drama,War
the-invisible-woman	Comedy,Romance,Sci-Fi
spellbound	Drama,Horror
stranger-on-the-third-floor	Crime,Drama,Film-Noir
citizen-kane	Drama,Mystery
the-getaway	Crime,Drama,Mystery
casablanca	Drama,Romance,War
cat-people	Fantasy,Horror,Thriller
the-avengers	Drama,War
the-magnificent-ambersons	Drama,Romance
saboteur	Thriller,War
batman	Action,Adventure,Crime
destroyer	Adventure,Drama,War
elvira-madigan	Drama
meshes-of-the-afternoon	Fantasy,Mystery,Short
the-adventures-of-baron-munchausen	Adventure,Comedy,Fantasy
the-seventh-victim	Drama,Horror,Mystery
shadow-of-a-doubt	Thriller
sanshiro-sugata	Action,Adventure,Drama
brazil	Comedy,Musical,Romance
dark-shadows	Crime,Drama,Short
the-best-years-of-our-lives	Drama,Romance,War
the-most-beautiful	Drama
murder-my-sweet	Crime,Drama,Film-Noir
thoroughbreds	Drama
the-town	Short
jubilee	Drama,Short
brief-encounter	Drama,Romance
dead-of-night	Drama,Horror
they-were-expendable	Drama,War
the-men-who-tread-on-the-tigers-tail	Adventure,Drama,Thriller
vertigo	Drama
it-rains-on-our-love	Drama,Romance
its-a-wonderful-life	Drama,Family,Fantasy
crisis	Drama,Romance
my-darling-clementine	Biography,Drama,Western
notorious	Drama,Film-Noir,Romance
the-postman-always-rings-twice	Crime,Drama,Film-Noir
no-regrets-for-our-youth	Drama
black-narcissus	Drama
phoenix	Drama,Romance
nightmare-alley	Drama,Film-Noir
odd-man-out	Crime,Drama,Film-Noir
the-secret-life-of-walter-mitty	Comedy,Fantasy,Romance
one-wonderful-sunday	Drama,Romance
spring	Comedy,Musical,Romance
port-of-call	Drama
the-lady-from-shanghai	Crime,Drama,Film-Noir
music-in-darkness	Drama
the-red-shoes	Drama,Music,Romance
rope	Crime,Drama,Mystery
saraband	Biography,Drama,History
whiplash	Drama,Film-Noir,Sport
drunken-angel	Crime,Drama,Romance
mama	Comedy,Drama,Family
prison	Drama
gigi	Comedy,Romance
helter-skelter	Comedy,Fantasy,Romance
stray-dog	Crime,Drama,Film-Noir
puce-moment	Short
the-quiet-duel	Drama
the-third-man	Film-Noir,Mystery,Thriller
annie-get-your-gun	Biography,Comedy,Musical
the-blue-lamp	Crime,Drama,Thriller
cold-war	Animation,Comedy,Family
dark-city	Crime,Drama,Film-Noir
in-a-lonely-place	Drama,Film-Noir,Mystery
variety-lights	Drama,Music,Romance
pretty-baby	Comedy
rabbits-moon	Drama,Fantasy,Short
rashomon	Crime,Drama,Mystery
to-joy	Drama
an-american-in-paris	Drama,Musical,Romance
ace-in-the-hole	Drama,Film-Noir
the-day-the-earth-stood-still	Drama,Sci-Fi
the-guest	Drama,Short
the-idiot	Drama,Romance
i-want-you	Drama
boyhood	Drama,War
summer-interlude	Drama,Romance
strangers-on-a-train	Crime,Film-Noir,Thriller
the-hunter	Drama
the-assassin	Crime,Mystery,Thriller
carrie	Drama,Romance
face-to-face	Drama,Western
fargo	Action,Adventure,Western
ikiru	Drama
singin-in-the-rain	Comedy,Musical,Romance
calamity-jane	Comedy,Musical,Romance
childs-play	Comedy,Sci-Fi
mandy	Drama
eaux-dartifice	Short
sawdust-and-tinsel	Drama
how-to-marry-a-millionaire	Comedy,Drama,Romance
invaders-from-mars	Horror,Sci-Fi
never-let-me-go	Adventure,Drama,Romance
the-robe	Drama,History
roman-holiday	Comedy,Romance
summer-with-monika	Drama,Romance
stalag-17	Comedy,Drama,War
i-vitelloni	Comedy,Drama
godzilla	Drama,Horror,Sci-Fi
inauguration-of-the-pleasure-dome	Fantasy,Horror,Short
johnny-guitar	Drama,Western
a-lesson-in-love	Comedy,Drama,Romance
rear-window	Mystery,Thriller
seven-samurai	Action,Adventure,Drama
la-strada	Drama
taxi-driver	Musical,Romance
artists-and-models	Comedy,Musical,Romance
il-bidone	Comedy,Drama
bob-le-flambeur	Crime,Drama,Thriller
the-warriors	Adventure,Drama,History
the-deep-blue-sea	Drama,Romance
guys-and-dolls	Comedy,Crime,Musical
i-live-in-fear	Drama
killers-kiss	Crime,Drama,Film-Noir
dreams	Drama
the-ladykillers	Comedy,Crime
mr-arkadin	Crime,Drama,Film-Noir
the-night-of-the-hunter	Crime,Drama,Film-Noir
la-pointe-courte	Drama
rebel-without-a-cause	Drama
romeo-juliet	Drama,Music,Romance
smiles-of-a-summer-night	Comedy,Romance
the-trouble-with-harry	Comedy,Mystery
the-girl-cant-help-it	Comedy,Music
the-imposter	Drama
the-killing	Crime,Drama,Film-Noir
i-vampiri	Horror
love-me-tender	Drama,Musical,Romance
lust-for-life	Biography,Drama
the-searchers	Adventure,Drama,Western
12-angry-men	Drama
throne-of-blood	Drama,History
night-of-the-demon	Fantasy,Horror,Mystery
paths-of-glory	Drama,War
the-seventh-seal	Drama,Fantasy
wild-strawberries	Drama,Romance
sweet-smell-of-success	Drama,Film-Noir
elevator-to-the-gallows-ascenseur-pour-lechafaud	Crime,Drama,Thriller
cairo-station	Comedy,Crime,Drama
bell-book-and-candle	Comedy,Fantasy,Romance
dunkirk	Action,Drama,History
the-fly	Drama,Horror,Sci-Fi
the-tenant	Drama
the-hidden-fortress	Adventure,Drama
brink-of-life	Drama
a-time-to-love-and-a-time-to-die	Drama,Romance,War
touch-of-evil	Crime,Drama,Film-Noir
the-untouchables	Action,Crime,Drama
les-amants	Drama,Romance
labyrinth	Drama
north-by-northwest	Adventure,Mystery,Thriller
on-the-beach	Drama,Romance,Sci-Fi
the-400-blows	Crime,Drama
rio-bravo	Action,Drama,Western
le-signe-du-lion	Drama
suddenly-last-summer	Drama,Mystery,Thriller
floating-weeds	Drama
a-bout-de-souffle-breathless	Crime,Drama
lavventura	Drama,Mystery
the-devils-eye	Comedy,Drama,Fantasy
la-dolce-vita	Comedy,Drama
the-virgin-spring	Drama
black-sunday	Horror
la-notte	Drama
oceans-eleven	Comedy,Crime,Music
le-petit-soldat	Drama,War
purple-noon-plein-soleil	Crime,Drama,Thriller
psycho	Horror,Mystery,Thriller
shoot-the-piano-player-tirez-sur-le-pianiste	Crime,Drama,Thriller
the-party	Drama
the-bad-sleep-well	Crime,Drama,Thriller
zazie-dans-le-metro	Comedy,Fantasy
blast-of-silence	Crime,Drama,Thriller
the-hustler	Drama,Sport
the-innocents	Horror
jules-et-jim	Drama,Romance
leon-morin-priest	Drama,Romance,War
leviathan	Drama
through-a-glass-darkly	Drama
une-femme-est-une-femme-a-woman-is-a-woman	Comedy,Drama,Romance
yojimbo	Action,Drama,Thriller
cape-fear	Drama,Thriller
carnival-of-souls	Horror,Mystery
cleo-from-5-to-7	Comedy,Drama,Music
weekend	Comedy,Drama,Romance
ivans-childhood	Drama,War
la-jetee	Drama,Romance,Sci-Fi
lawrence-of-arabia	Adventure,Biography,Drama
lolita	Crime,Drama,Romance
where-the-truth-lies	Thriller
the-miracle-worker	Biography,Drama
knife-in-the-water	Drama,Thriller
ride-the-high-country	Drama,Western
sanjuro	Action,Comedy,Crime
to-kill-a-mockingbird	Crime,Drama
vivre-sa-vie	Drama
the-birds	Drama,Horror,Mystery
the-double	Drama,Mystery
dr-strangelove-or-how-i-learned-to-stop-worrying-and-love-the-bomb	Comedy
le-feu-follet	Drama
the-leopard	Drama,History
the-haunting	Horror
hud	Drama,Western
audition	Documentary,Music
contempt-le-mepris	Drama,Romance
winter-light	Drama
the-trial	Drama,Mystery,Thriller
the-quick-and-the-dead	Action,Drama,War
the-servant	Drama
shock-corridor	Drama,Mystery
the-tempest	Drama
black-sabbath	Horror
the-silence	Drama
band-of-outsiders-bande-a-part	Comedy,Crime,Drama
all-these-women	Comedy
a-hard-days-night	Comedy,Music,Musical
lemonade-joe	Adventure,Comedy,Musical
kwaidan	Drama,Fantasy,Horror
marnie	Crime,Drama,Mystery
mary-poppins	Comedy,Family,Fantasy
the-masque-of-the-red-death	Horror
gate-of-flesh	Drama
onibaba	Drama,Horror
the-umbrellas-of-cherbourg	Drama,Musical,Romance
la-peau-douce-the-soft-skin	Drama,Romance
the-return	Drama
scorpio-rising	Music,Short
blood-and-black-lace	Horror,Mystery,Thriller
i-am-cuba	Drama,History,War
the-thin-red-line	Drama,War
une-femme-mariee	Drama
red-beard	Drama
alice	Drama
alphaville	Drama,Mystery,Sci-Fi
doctor-zhivago	Drama,Romance,War
faster-pussycat-kill-kill	Action,Comedy
tabu	Adventure
juliet-of-the-spirits	Comedy,Drama,Fantasy
kustom-kar-kommandos	Music,Short
the-passenger	Crime,Drama
for-a-few-dollars-more	Western
phenomena	Short
repulsion	Drama,Horror,Thriller
the-sound-of-music	Biography,Drama,Family
planet-of-the-vampires	Horror,Sci-Fi
star-trek	Action,Adventure,Sci-Fi
blow-up	Drama,Mystery,Thriller
the-good-the-bad-and-the-ugly	Western
les-creatures	Drama,Fantasy
cul-de-sac	Comedy,Drama,Thriller
fahrenheit-451	Drama,Sci-Fi
misunderstood	Drama
made-in-usa	Comedy,Crime,Mystery
out-of-sight	Comedy
persona	Drama,Thriller
who-are-you-polly-maggoo	Comedy,Drama
the-nun	Drama
seconds	Sci-Fi,Thriller
daisies	Comedy
dr-goldfoot-and-the-girl-bombs	Adventure,Comedy,Sci-Fi
hunger	Drama
whos-afraid-of-virginia-woolf	Drama
away-we-go	Comedy,Music
birdman	Action,Adventure,Animation
speed-racer	Action,Adventure,Animation
spider-man	Adventure,Animation,Family
accident	Drama
the-rover	Adventure,Drama,History
belle-de-jour	Drama
bonnie-and-clyde	Action,Biography,Crime
the-box	Animation,Short
casino-royale	Comedy
la-collectionneuse	Comedy,Drama,Romance
fando-y-lis	Adventure,Fantasy
far-from-the-madding-crowd	Drama,History,Romance
the-fearless-vampire-killers	Comedy,Horror
the-graduate	Comedy,Drama,Romance
in-cold-blood	Biography,Crime,Drama
love-affair-or-the-case-of-the-missing-switchboard-operator	Comedy,Drama,Romance
the-shooting	Western
the-sorcerers	Horror,Sci-Fi
the-trip	Drama
viy	Drama,Fantasy,Horror
the-thief-of-paris	Comedy,Crime,Drama
2001-a-space-odyssey	Adventure,Sci-Fi
blue	Romance,Western
boom	Drama,Thriller
danger-diabolik	Action,Comedy,Crime
les-demoiselles-de-rochefort	Comedy,Drama,Musical
effi-briest	Drama
funny-girl	Biography,Comedy,Drama
the-girl-on-a-motorcycle	Drama,Romance
the-immortal-story	Drama
death-by-hanging	Comedy,Crime,Drama
marketa-lazarova	Drama,History,Romance
witchfinder-general	Biography,Drama,Horror
innocence-unprotected	Comedy,Documentary,Drama
night-of-the-living-dead	Horror
our-lady-of-the-turks	Drama
petulia	Drama,Romance
planet-of-the-apes	Adventure,Sci-Fi
rosemarys-baby	Drama,Horror
targets	Crime,Drama,Thriller
the-thomas-crown-affair	Crime,Drama,Romance
hour-of-the-wolf	Drama,Horror
whos-that-knocking-at-my-door	Drama,Romance
the-garden	Drama,Short
if	Crime,Drama
age-of-consent	Biography,Comedy,Drama
le-boucher	Drama,Thriller
butch-cassidy-and-the-sundance-kid	Biography,Crime,Drama
once-upon-a-time-in-the-west	Western
carne	Drama
easy-rider	Adventure,Drama
eika-katappa	Comedy,Drama
the-wild-child	Drama
the-fall	Documentary,Music
the-girl-who-knew-too-much	Crime,Drama
invocation-of-my-demon-brother	Horror,Short
katzelmacher	Drama
love-is-colder-than-death	Comedy,Crime
lions-love	Comedy,Drama
my-night-at-mauds-ma-nuit-chez-maud	Comedy,Drama,Romance
midnight-cowboy	Drama,Western
fruit-of-paradise	Drama
the-passion-of-anna	Drama
the-rite	Drama
mississippi-mermaid	Crime,Drama,Romance
sweet-charity	Comedy,Drama,Music
a-quiet-place-in-the-country	Drama,Horror
true-grit	Adventure,Drama,Western
the-bird-with-the-crystal-plumage	Horror,Mystery,Thriller
the-wild-bunch	Action,Adventure,Western
wonderwall	Drama
the-american-soldier	Drama
even-dwarfs-started-small	Comedy,Drama
the-ballad-of-cable-hogue	Comedy,Drama,Romance
brewster-mccloud	Comedy,Fantasy
catch-22	Comedy,Drama,War
le-cercle-rouge	Crime,Drama,Thriller
the-conformist	Drama
dodeska-den	Drama
bed-board	Comedy,Drama
edward-ii	Drama,History
five-easy-pieces	Drama
claires-knee	Drama,Romance
gods-of-the-plague	Crime,Drama
joe	Drama,Thriller
a-swedish-love-story	Drama,Romance
little-big-man	Adventure,Comedy,Drama
lucifer-rising	Fantasy,Short
mash	Comedy,Drama,War
death-occurred-last-night	Crime,Drama,Thriller
deep-end	Comedy,Drama,Romance
the-niklashausen-journey	Drama
on-a-clear-day-you-can-see-forever	Comedy,Drama,Fantasy
donkey-skin	Drama,Family,Fantasy
performance	Crime,Drama
puzzle-of-a-downfall-child	Drama
vampyros-lesbos	Drama,Horror
thx-1138	Drama,Sci-Fi,Thriller
the-tribe	Drama
tristana	Drama
cuadecuc-vampir	Documentary,Horror
four-flies-on-grey-velvet	Crime,Mystery,Thriller
the-beguiled	Drama,Thriller,War
carnal-knowledge	Drama
a-clockwork-orange	Crime,Drama,Sci-Fi
the-clowns	Comedy,Documentary
the-devils-backbone	Western
two-english-girls	Drama,Romance
the-devils	Biography,Drama,History
evolution	Animation,Comedy,Fantasy
fata-morgana	Comedy,Documentary,Drama
the-french-connection	Action,Crime,Drama
the-fifth-cord	Crime,Mystery,Thriller
the-go-between	Drama,Romance
harold-and-maude	Comedy,Drama,Romance
the-hired-hand	Drama,Western
jabberwocky	Animation,Fantasy,Short
klute	Crime,Mystery,Thriller
the-last-picture-show	Drama,Romance
lets-scare-jessica-to-death	Drama,Horror,Mystery
a-lizard-in-a-womans-skin	Mystery,Thriller
malpertuis	Drama,Fantasy,Horror
death-in-venice	Drama
wake-in-fright	Drama,Thriller
pink-narcissus	Drama,Fantasy
rio-das-mortes	Comedy
daughters-of-darkness	Horror
a-safe-place	Drama
the-selfish-giant	Animation,Short
silent-running	Drama,Sci-Fi
straw-dogs	Crime,Drama,Thriller
thief	Crime,Drama
el-topo	Drama,Western
two-lane-blacktop	Drama
un-flic	Crime,Thriller
vampire-circus	Horror
vanishing-point	Action,Crime,Thriller
venom	Horror
wr-mysteries-of-the-organism	Comedy,Drama,Fantasy
walkabout	Adventure,Drama
beware-of-a-holy-whore	Comedy,Drama
whity	Drama,Western
willy-wonka-the-chocolate-factory	Family,Fantasy,Musical
aguirre-the-wrath-of-god-aguirre-der-zorn-gottes	Action,Adventure,Biography
the-bitter-tears-of-petra-von-kant	Drama,Romance
dr-phibes-rises-again	Comedy,Horror
fat-city	Drama,Sport
the-godfather	Crime,Drama
heat	Comedy,Drama,Romance
images	Drama,Horror,Mystery
the-king-of-marvin-gardens	Drama
lone-wolf-and-cub-sword-of-vengeance	Action,Adventure
lone-wolf-and-cub-baby-cart-to-hades	Action,Drama
limbo	Drama
lisa-and-the-devil	Horror,Mystery
dont-torture-a-duckling	Horror,Mystery,Thriller
the-other-side-of-the-wind	Drama
four-times-that-night	Comedy,Romance
roma	Comedy,Drama
savages	Comedy,Fantasy
solaris	Drama,Mystery,Sci-Fi
tout-va-bien	Drama
nuits-rouges	Crime,Mystery
american-graffiti	Comedy,Drama
badlands	Crime,Drama
certain-women	Drama
electra-glide-in-blue	Crime,Drama,Mystery
enter-the-dragon	Action,Crime,Drama
the-exorcist	Horror
successive-slidings-of-pleasure-glissements-progressifs-du-plaisir	Fantasy,Horror,Thriller
the-invitation	Comedy,Drama
kamouraska	Drama,History
the-last-detail	Comedy,Drama
the-long-goodbye	Comedy,Crime,Drama
mean-streets	Crime,Drama,Thriller
day-for-night	Comedy,Drama,Romance
paper-moon	Comedy,Drama
papillon	Biography,Crime,Drama
pat-garrett-billy-the-kid	Biography,Drama,Western
scarecrow	Drama
scenes-from-a-marriage	Drama
u-turn	Drama
world-on-a-wire	Crime,Mystery,Sci-Fi
the-wicker-man	Horror,Mystery,Thriller
the-wrestler	Action,Crime,Drama
zardoz	Adventure,Fantasy,Sci-Fi
tenderness-of-the-wolves	Crime,Drama,Thriller
rush	Adventure,Drama,History
alice-doesnt-live-here-anymore	Drama,Romance
amarcord	Comedy,Drama
ali-fear-eats-the-soul	Drama,Romance
a-bigger-splash	Biography,Documentary,Drama
blood-for-dracula	Horror
bring-me-the-head-of-alfredo-garcia	Action,Crime,Drama
california-split	Comedy,Drama
chinatown	Drama,Mystery,Thriller
cockfighter	Drama
immoral-tales	Drama,Romance
the-conversation	Drama,Mystery,Thriller
crash	Drama
daguerreotypes	Documentary
the-dead-dont-die	Horror,Thriller
messiah-of-evil	Horror
dersu-uzala	Adventure,Biography,Drama
the-godfather-part-ii	Crime,Drama
the-enigma-of-kaspar-hauser	Biography,Drama,History
lone-wolf-and-cub-white-heaven-in-hell	Action,Adventure,Drama
lenny	Biography,Drama
manhunter	Crime,Drama
monty-python-and-the-holy-grail	Adventure,Comedy,Fantasy
the-immortals	Action,Adventure,History
the-parallax-view	Drama,Thriller
sweet-movie	Comedy,Drama,Mystery
thieves-like-us	Crime,Drama,Romance
wonder-woman	Fantasy
sunset-song	Drama
fear-of-fear	Drama
barry-lyndon	Adventure,Drama,History
bug	Horror,Mystery,Sci-Fi
f-for-fake	Documentary
fox-and-his-friends	Drama,Romance
the-fortune	Comedy,Crime,Romance
the-story-of-adele-h	Biography,Drama,History
kings-of-the-road-im-lauf-der-zeit	Drama
jaws	Adventure,Drama,Thriller
katie-tippel	Drama
mother-kusters-goes-to-heaven	Drama
nashville	Comedy,Drama,Music
next-door	Short
night-moves	Crime,Mystery,Thriller
one-flew-over-the-cuckoos-nest	Drama
picnic-at-hanging-rock	Drama,Mystery
deep-red	Horror,Mystery,Thriller
the-rocky-horror-picture-show	Comedy,Musical
the-runaways	Adventure,Drama,Family
three-days-of-the-condor	Mystery,Thriller
the-magic-flute	Comedy,Fantasy,Music
small-change	Comedy,Drama
assault-on-precinct-13	Action,Crime,Thriller
bound-for-glory	Biography,Drama,Music
buffalo-bill-and-the-indians-or-sitting-bulls-history-lesson	Comedy,Western
fellinis-casanova	Biography,Drama,History
chinese-roulette	Drama,Thriller
eraserhead	Horror
heart-of-glass	Drama
the-killer-inside-me	Crime,Drama
the-man-who-fell-to-earth	Drama,Sci-Fi
marathon-man	Crime,Thriller
maitresse	Drama,Romance
mr-klein	Crime,Drama,Mystery
the-omen	Horror
pleasantville	Drama
satans-brew	Comedy,Drama,Romance
sebastiane	Drama,Romance
stroszek	Comedy,Drama
todo-modo	Drama
tracks	Drama
3-women	Drama,Mystery,Thriller
the-american-friend	Crime,Drama,Mystery
annie-hall	Comedy,Romance
close-encounters-of-the-third-kind	Drama,Sci-Fi
demon-seed	Horror,Sci-Fi
the-wishing-tree	Drama
house-hausu	Comedy,Horror
the-incredible-hulk	Action,Adventure,Drama
news-from-home	Documentary
petes-dragon	Adventure,Animation,Comedy
the-serpents-egg	Drama,Mystery,Thriller
soldier-of-orange	Drama,Romance,Thriller
sorcerer	Adventure,Drama,Thriller
star-wars	Action,Adventure,Fantasy
suspiria	Horror
lune-chante-lautre-pas	Drama,History
matador	Drama
the-thing	Adventure,Animation,Family
coming-home	Drama,Romance,War
family-nest	Drama
dawn-of-the-dead	Horror,Thriller
days-of-heaven	Drama,Romance
the-deer-hunter	Drama,War
despair	Drama
grease	Musical,Romance
halloween	Horror,Thriller
autumn-sonata	Drama,Music
martin	Drama,Horror
the-kingdom-of-naples	Drama
alien	Horror,Sci-Fi
all-that-jazz	Drama,Music,Musical
camera-buff	Comedy,Drama,Romance
apocalypse-now	Drama,Mystery,War
being-there	Comedy,Drama
the-brood	Horror,Sci-Fi
the-marriage-of-maria-braun	Drama
hardcore	Crime,Drama
life-of-brian	Comedy
mad-max	Action,Adventure,Sci-Fi
mirror-mirror	Drama
nosferatu-the-vampyre-nosferatu-phantom-der-nacht	Drama,Horror
orchestra-rehearsal	Comedy,Drama,Music
quintet	Drama,Mystery,Sci-Fi
stalker	Drama,Sci-Fi
woyzeck	Drama
tinker-tailor-soldier-spy	Drama,Thriller
american-gigolo	Crime,Drama,Mystery
arrival	Documentary,Short
from-the-life-of-the-marionettes	Drama
casino	Adventure,Drama
city-of-women	Comedy,Drama,Fantasy
cruising	Crime,Drama,Mystery
the-elephant-man	Biography,Drama
golem	Sci-Fi
haywire	Biography,Drama
heavens-gate	Adventure,Drama,Western
kagemusha	Drama,History,War
mur-murs	Documentary
pepi-luci-bom-and-other-girls-like-mom	Comedy
popeye	Adventure,Comedy,Family
raging-bull	Biography,Drama,Sport
scanners	Horror,Sci-Fi,Thriller
the-shining	Drama,Horror
spetters	Drama,Romance,Sport
stardust-memories	Comedy,Drama
time-bandits	Adventure,Comedy,Fantasy
union-city	Comedy,Drama,Mystery
an-american-werewolf-in-london	Comedy,Horror
blow-out	Mystery,Thriller
body-heat	Crime,Drama,Romance
diva	Thriller
documenteur	Drama
the-funhouse	Horror
lili-marleen	Drama,Music,Romance
mad-max-2	Action,Adventure,Sci-Fi
ms-45	Crime,Drama,Thriller
possession	Drama,Horror
raiders-of-the-lost-ark	Action,Adventure
roadgames	Mystery,Thriller
road-games	Mystery,Thriller
the-war-of-the-worlds-next-century	Sci-Fi,Thriller
blade-runner	Action,Sci-Fi,Thriller
creepshow	Comedy,Fantasy,Horror
et-the-extra-terrestrial	Family,Sci-Fi
fanny-and-alexander	Drama
first-blood	Action,Adventure
hero	Adventure,Drama,Fantasy
labyrinth-of-passion	Comedy,Drama,Romance
moonlight	Action
one-from-the-heart	Drama,Musical,Romance
pink-floyd-the-wall	Animation,Drama,Fantasy
poltergeist	Horror,Thriller
querelle	Drama
veronika-voss	Drama
the-state-of-things	Drama
widows	Crime,Drama
the-dead-zone	Drama,Horror,Sci-Fi
dark-habits	Comedy,Drama
the-hunger	Drama,Horror
the-king-of-comedy	Comedy,Crime,Drama
the-moon-in-the-gutter	Drama
the-man-who-wasnt-there	Action,Adventure,Comedy
pauline-at-the-beach-pauline-a-la-plage	Comedy,Drama,Romance
first-name-carmen	Crime,Drama,Music
rumble-fish	Crime,Drama,Romance
scream	Horror,Mystery
super	Action,Crime,Drama
videodrome	Horror,Sci-Fi,Thriller
life-is-a-bed-of-roses	Comedy,Drama,Musical
the-master	Action,Adventure,Drama
after-hours	Drama,Short
love-unto-death	Drama,Romance
blood-simple	Crime,Drama,Thriller
the-brother-from-another-planet	Comedy,Sci-Fi
the-company-of-wolves	Drama,Fantasy,Horror
the-cotton-club	Crime,Drama,Music
a-summer-at-grandpas	Drama
dune	Action,Adventure,Sci-Fi
and-the-ship-sails-on	Drama,History,Music
after-the-rehearsal	Drama
ghostbusters	Action,Comedy,Fantasy
the-illusionist	Comedy
indiana-jones-and-the-temple-of-doom	Action,Adventure
a-nightmare-on-elm-street	Horror
once-upon-a-time-in-america	Crime,Drama
almanac-of-fall	Drama
paris-texas	Drama
repo-man	Comedy,Crime,Sci-Fi
starman	Romance,Sci-Fi
stranger-than-paradise	Comedy,Drama
streets-of-fire	Action,Crime,Drama
the-terminator	Action,Sci-Fi
z-for-zachariah	Comedy,Drama
what-have-i-done-to-deserve-this	Comedy,Drama
half-nelson	Comedy,Drama
the-angelic-conversation	Drama
back-to-the-future	Adventure,Comedy,Sci-Fi
the-coca-cola-kid	Comedy,Drama
day-of-the-dead	Horror,Thriller
detective	Comedy,Crime,Drama
insignificance	Comedy,Drama
hail-mary	Drama
mad-max-beyond-thunderdome	Action,Adventure,Sci-Fi
mishima-a-life-in-four-chapters	Biography,Drama
a-nightmare-on-elm-street-2-freddys-revenge	Horror
pee-wees-big-adventure	Adventure,Comedy,Family
ran	Action,Drama
re-animator	Comedy,Horror,Sci-Fi
vagabond	Drama,Romance
subway	Thriller
to-live-and-die-in-la	Action,Crime,Drama
in-a-glass-cage	Drama,Horror
betty-blue	Drama,Romance
aliens	Action,Adventure,Sci-Fi
big-trouble-in-little-china	Action,Adventure,Comedy
blue-velvet	Drama,Mystery,Thriller
caravaggio	Biography,Drama,History
coffee-and-cigarettes	Comedy,Short
down-by-law	Comedy,Crime,Drama
elysium	Drama,War
from-beyond	Horror,Sci-Fi
the-terrorizers	Crime,Drama
dust-in-the-wind	Drama,Romance
dust-devil	Drama
my-beautiful-laundrette	Comedy,Drama,Romance
dead-mans-letters	Drama,Sci-Fi
platoon	Drama,War
stand-by-me	Adventure,Drama
under-the-cherry-moon	Comedy,Drama,Music
au-revoir-les-enfants	Drama,War
barfly	Comedy,Drama,Romance
control	Drama,Thriller
creepshow-2	Comedy,Fantasy,Horror
dead-man-walking	Action,Sci-Fi
evil-dead-ii	Comedy,Horror
full-metal-jacket	Drama,War
hellraiser	Horror,Thriller
wings-of-desire	Drama,Fantasy,Romance
intervista	Comedy,Drama,Fantasy
jane-b-par-agnes-v	Biography,Fantasy
kung-fu-master	Drama,Romance
the-last-of-england	Drama,Fantasy
law-of-desire	Comedy,Drama,Thriller
matewan	Drama,History
near-dark	Action,Crime,Drama
a-nightmare-on-elm-street-3-dream-warriors	Fantasy,Horror
predator	Action,Adventure,Sci-Fi
raising-arizona	Comedy,Crime
robocop	Action,Crime,Sci-Fi
keep-your-right-up	Comedy,Drama,Fantasy
the-survivalist	Action,Drama,Sci-Fi
white-of-the-eye	Horror,Thriller
war-of-the-worlds	Action,Drama,Horror
beetlejuice	Comedy,Fantasy
the-big-blue	Drama
chocolat	Drama
dead-ringers	Drama,Horror,Thriller
die-hard	Action,Thriller
distant-voices-still-lives	Drama,Music
ghosts-of-the-civil-dead	Crime,Drama
lincoln	Drama,History,War
damnation	Crime,Drama,Romance
the-last-temptation-of-christ	Drama
women-on-the-verge-of-a-nervous-breakdown	Comedy,Drama
a-nightmare-on-elm-street-4-the-dream-master	Horror
cinema-paradiso	Drama
patty-hearst	Biography,Drama
powaqqatsi	Documentary,Music
promised-land	Drama
tales-from-the-gimli-hospital	Comedy,Drama,Fantasy
the-thin-blue-line	Crime,Documentary,Drama
the-unbearable-lightness-of-being	Drama,Romance
war-requiem	Drama,War
who-framed-roger-rabbit	Adventure,Animation,Comedy
as-tears-go-by	Crime,Drama,Romance
black-snow	Action
blaze	Biography,Drama
catch-me-if-you-can	Action,Comedy,Drama
a-tale-of-springtime	Comedy,Drama,Romance
crimes-and-misdemeanors	Comedy,Drama
do-the-right-thing	Comedy,Drama
drugstore-cowboy	Crime,Drama
elephant	Crime,Drama,Short
force-majeure	Drama
happy-together	Comedy,Romance
i-want-to-go-home	Comedy
indiana-jones-and-the-last-crusade	Action,Adventure
melancholia	Crime,Drama,Thriller
milou-en-mai	Comedy,Romance
mystery-train	Comedy,Crime,Drama
a-nightmare-on-elm-street-5-the-dream-child	Fantasy,Horror
roadkill	Adventure,Comedy,Drama
roselyne-and-the-lions	Comedy,Drama,Romance
santa-sangre	Drama,Fantasy,Horror
the-seventh-continent	Drama
to-die-for	Horror,Romance,Thriller
the-voice-of-the-moon	Comedy,Drama
sugar	Comedy,Sci-Fi
sex-lies-and-videotape	Drama
archangel	Comedy,Drama,Romance
back-to-the-future-part-iii	Adventure,Comedy,Sci-Fi
childs-play-2	Horror,Thriller
the-comfort-of-strangers	Drama,Thriller
dances-with-wolves	Adventure,Drama,Western
edward-scissorhands	Drama,Fantasy,Romance
enemy	Action,Adventure,Drama
goodfellas	Biography,Crime,Drama
graffiti-bridge	Drama,Music
hardware	Sci-Fi,Thriller
hidden-agenda	Drama,Thriller
the-hunt-for-red-october	Action,Adventure,Thriller
millers-crossing	Crime,Drama,Thriller
misery	Drama,Thriller
mo-better-blues	Drama,Music,Romance
nikita	Action,Thriller
the-pit-and-the-pendulum	Horror,Romance
the-rainbow-thief	Drama,Fantasy
total-recall	Action,Sci-Fi,Thriller
wild-at-heart	Comedy,Crime,Drama
tie-me-up-tie-me-down	Comedy,Crime,Drama
days-of-being-wild	Crime,Drama,Romance
les-amants-du-pont-neuf-the-lovers-on-the-bridge	Drama,Romance
barton-fink	Comedy,Drama,Thriller
raise-the-red-lantern	Drama,History,Romance
delicatessen	Comedy,Crime
the-double-life-of-veronique	Drama,Fantasy,Music
the-fisher-king	Comedy,Drama,Fantasy
freddys-dead-the-final-nightmare	Fantasy,Horror
rhapsody-in-august	Drama
highway-61	Comedy,Music
the-indian-runner	Drama
jfk	Drama,History,Thriller
jacquot-de-nantes	Biography,Drama
kafka	Drama,Mystery,Sci-Fi
light-sleeper	Crime,Drama
my-own-private-idaho	Drama
naked-lunch	Drama
night-on-earth	Comedy,Drama
the-rapture	Drama,Mystery
samsara	Short
the-silence-of-the-lambs	Crime,Drama,Thriller
slacker	Comedy,Drama
annihilation	Documentary,Short
baraka	Documentary
basic-instinct	Drama,Mystery,Thriller
batman-returns	Action,Crime,Fantasy
bennys-video	Crime,Drama
bram-stokers-dracula	Horror
candyman	Horror,Thriller
careful	Comedy,Drama,Romance
chaplin	Biography,Comedy,Drama
childs-play-3	Horror,Thriller
cronos	Horror
the-crying-game	Crime,Drama,Romance
dark-horse	Drama,Family
gladiator	Action,Drama,Sport
the-long-day-closes	Biography,Drama
reservoir-dogs	Crime,Drama,Thriller
twin-peaks-fire-walk-with-me	Drama,Horror,Mystery
unforgiven	Drama,Western
invincible	Action,Thriller
fallen-angels	Crime,Drama,Mystery
the-man-who-cried	Drama
carlitos-way	Crime,Drama,Thriller
groundhog-day	Comedy,Fantasy,Romance
hocus-pocus	Comedy,Family,Fantasy
helas-pour-moi	Comedy,Drama,Fantasy
inland-empire	Action,Comedy,Crime
jurassic-park	Action,Adventure,Sci-Fi
kika	Comedy
king-of-the-hill	Drama,History
naked	Comedy,Drama
noah	Animation,Short
orlando	Biography,Drama,Fantasy
the-piano	Drama,Music,Romance
safe	Drama
schindlers-list	Biography,Drama,History
short-cuts	Comedy,Drama
true-romance	Crime,Drama,Romance
wittgenstein	Biography,Comedy,Drama
side-effects	Drama
71-fragments-of-a-chronology-of-chance	Drama
bottle-rocket	Comedy,Crime,Drama
chloe	Drama,Romance
chungking-express	Comedy,Crime,Drama
double-happiness	Drama,Romance
ed-wood	Biography,Comedy,Drama
exotica	Drama
glitterbug	Documentary
hail-caesar	Comedy
heavenly-creatures	Biography,Crime,Drama
the-hudsucker-proxy	Comedy,Drama,Fantasy
insomnia	Comedy
i-cant-sleep	Drama,Mystery,Romance
leon-the-professional	Action,Crime,Drama
natural-born-killers	Crime,Drama
oblivion	Adventure,Comedy,Sci-Fi
pulp-fiction	Crime,Drama
river-of-grass	Drama
the-secret-of-roan-inish	Drama,Family,Fantasy
shallow-grave	Crime,Thriller
the-shawshank-redemption	Drama
sicario	Drama
satantango	Drama
la-vie-en-rose	Drama,Short
batman-forever	Action,Adventure,Fantasy
the-beach	Short
before-sunrise	Drama,Romance
butterfly-kiss	Comedy,Drama,Romance
one-hundred-and-one-nights	Comedy,History,Romance
the-city-of-lost-children	Fantasy,Sci-Fi
clockers	Crime,Drama,Mystery
the-crossing-guard	Drama,Thriller
dead-man	Drama,Fantasy,Western
the-flower-of-my-secret	Drama
la-haine	Crime,Drama
in-the-mouth-of-madness	Drama,Horror,Mystery
leaving-las-vegas	Drama,Romance
mommy	Horror,Mystery,Thriller
the-neon-bible	Drama
se7en	Crime,Drama,Mystery
showgirls	Drama
twelve-monkeys	Mystery,Sci-Fi,Thriller
the-underneath	Crime,Thriller
the-usual-suspects	Crime,Mystery,Thriller
under-the-skin	Crime,Drama,Romance
bernie	Comedy
breaking-the-waves	Drama
for-ever-mozart	Comedy,Drama,War
grays-anatomy	Comedy,Drama
hugo	Short
irma-vep	Comedy,Drama
jude	Drama,Romance
lost-highway	Mystery,Thriller
mars-attacks	Comedy,Sci-Fi
michael-collins	Biography,Drama,Thriller
nenette-et-boni	Drama
schizopolis	Comedy,Fantasy,Mystery
trainspotting	Drama
lawless	Drama
alien-resurrection	Action,Horror,Sci-Fi
apt-pupil	Crime,Drama,Thriller
batman-robin	Action,Sci-Fi
in-the-mood-for-love	Drama,Romance
the-big-lebowski	Comedy,Crime,Sport
boogie-nights	Drama
buffalo-66	Comedy,Crime,Drama
live-flesh	Drama
the-fifth-element	Action,Adventure,Sci-Fi
funny-games	Crime,Drama,Thriller
gattaca	Drama,Sci-Fi,Thriller
good-will-hunting	Drama,Romance
gummo	Comedy,Drama
hard-eight	Crime,Drama
the-ice-storm	Drama
the-informant	Drama
jackie-brown	Crime,Drama,Thriller
la-confidential	Crime,Drama,Mystery
in-the-presence-of-a-clown	Drama
life-during-wartime	Comedy
mimic	Horror,Sci-Fi
prometheus	Drama
the-proposition	Adventure,Drama,Romance
scream-2	Horror,Mystery
three-kings	Action,Adventure,Comedy
starship-troopers	Action,Adventure,Sci-Fi
the-sweet-hereafter	Drama
songs-from-the-second-floor	Comedy,Drama
the-tango-lesson	Drama,Music,Romance
the-truman-show	Comedy,Drama,Sci-Fi
twentyfourseven	Comedy,Drama,Romance
twilight-of-the-ice-nymphs	Fantasy,Mystery,Romance
wonderland	Documentary
american-history-x	Drama
being-john-malkovich	Comedy,Drama,Fantasy
the-13th-warrior	Action,Adventure,History
eyes-wide-shut	Drama,Mystery,Thriller
fear-and-loathing-in-las-vegas	Adventure,Comedy,Drama
frida	Biography,Drama,Romance
in-dreams	Drama,Fantasy,Thriller
the-lord-of-the-rings-the-fellowship-of-the-ring	Adventure,Drama,Fantasy
resident-evil	Action,Horror,Sci-Fi
saving-private-ryan	Drama,War
snow-falling-on-cedars	Drama,Mystery,Romance
titus	Drama,History,Thriller
trance	Action,Comedy,Horror
velvet-goldmine	Drama,Music
existenz	Horror,Sci-Fi,Thriller
big-eyes	Comedy,Drama
memento	Short
the-arrival-of-joachim-stiller	Mystery
everyday	Short
and-the-fifth-horseman-is-fear	Drama,War
confessions	Adult
contagion	Comedy,Horror
cube	Drama,Mystery,Sci-Fi
amour	Drama
he-got-game	Drama,Sport
carriers	Thriller
high-rise	Adult,Comedy
man-on-the-moon	Biography,Comedy,Drama
land-of-plenty	Drama
calvary	Drama,Romance
no	Drama
rushmore	Comedy,Drama
ghost-stories	Drama,Horror,Mystery
run-lola-run	Crime,Drama,Thriller
american-beauty	Adult
the-matrix	Action,Sci-Fi
scream-3	Horror,Mystery
ride-with-the-devil	Drama,Romance,War
ginger-snaps	Adult
a-history-of-violence	Short
limitless	Short
fight-club	Drama
youre-next	Comedy,Crime,Mystery
intolerable-cruelty	Comedy,Crime,Romance
pi	Drama,Horror,Mystery
the-yards	Crime,Drama,Romance
bastards	Drama
filth	Adult
the-insider	Biography,Drama,Thriller
on-the-road	Drama,Short
lone-wolf-and-cub-baby-cart-in-peril	Action,Thriller
lone-wolf-and-cub-baby-cart-in-the-land-of-demons	Action,Crime,Drama
american-psycho	Crime,Drama
bride-of-chucky	Comedy,Horror
girl-on-the-bridge	Comedy,Drama,Romance
volver	Drama
birth	Animation,Comedy,Fantasy
dollhouse	Animation
surveillance	Comedy,Drama
pola-x	Drama,Romance
this-is-england	Documentary,Short
following	Crime,Mystery,Thriller
jigoku	Drama,Horror
gravity	Comedy,Short
the-hangover	Short
i-stand-alone-seul-contre-tous	Crime,Drama,Thriller
sunset-boulevard	Short
belly	Crime,Drama
lady-snowblood	Action,Drama,Thriller
the-virgin-suicides	Drama,Romance
cold-mountain	Adventure,Drama,History
keyhole	Documentary
zodiac	Comedy,Drama
der-bomberpilot	Drama
ghost-world	Comedy,Drama
sleepy-hollow	Fantasy,Horror,Mystery
summer-of-sam	Crime,Drama,Romance
the-road	Documentary
bringing-out-the-dead	Drama,Thriller
hollow-man	Action,Horror,Sci-Fi
ghost-dog-the-way-of-the-samurai	Action,Crime,Drama
the-limey	Crime,Drama,Mystery
the-straight-story	Biography,Drama
hellboy	Action,Adventure,Fantasy
the-lord-of-the-rings-the-return-of-the-king	Adventure,Drama,Fantasy
the-lord-of-the-rings-the-two-towers	Adventure,Drama,Fantasy
dancer-in-the-dark	Crime,Drama,Musical
the-man-from-london	Comedy,Crime
ratcatcher	Drama
boys-dont-cry	Biography,Crime,Drama
magnolia	Drama
requiem-for-a-dream	Drama
man-of-steel	Drama,Family,Fantasy
cheap-thrills	Adult
minority-report	Action,Crime,Mystery
traffic	Crime,Drama,Thriller
almost-famous	Adventure,Comedy,Drama
eloge-de-lamour	Drama
pollock	Biography,Drama
restless	Comedy,Romance
sin-city	Adult
all-about-my-mother	Drama
beast	Comedy
blade-ii	Action,Horror,Sci-Fi
last-days	Crime,Drama
shadow-of-the-vampire	Drama,Horror
children	Drama,Short
crouching-tiger-hidden-dragon	Action,Adventure,Fantasy
death-and-transfiguration	Drama,Short
madonna-and-child	Drama,Short
o-brother-where-art-thou	Adventure,Comedy,Crime
mr-nobody	Crime
julien-donkey-boy	Comedy,Drama
the-dreamers	Comedy,Short
the-end-of-the-tour	Drama
erin-brockovich	Biography,Drama
the-love-witch	Adult,Comedy
the-shape-of-water	Crime,Drama,Mystery
in-the-cut	Mystery,Thriller
a-room-for-romeo-brass	Comedy,Drama
sexy-beast	Crime,Drama,Thriller
trouble-every-day	Drama,Horror,Thriller
children-of-men	Drama,Thriller
the-hours	Short
mud	Comedy,Short
beau-travail	Drama,War
wild	Adult
amelie	Comedy,Romance
2046	Drama,Romance,Sci-Fi
ai-artificial-intelligence	Drama,Sci-Fi
bamboozled	Comedy,Short
code-unknown	Drama
something-in-the-air	Drama
scarlet-diva	Drama
maelstrom	Drama
snow-angels	Short
broken	Drama,Short,Thriller
down-in-the-valley	Musical
black-panther	Documentary,Short
the-matrix-reloaded	Action,Sci-Fi
the-theory-of-everything	Drama
the-pledge	Crime,Drama,Mystery
everybody-wants-some	Adult
the-matrix-revolutions	Action,Sci-Fi
waking-life	Animation,Drama,Fantasy
y-tu-mama-tambien	Drama
all-is-lost	Comedy,Short
donnie-darko	Drama,Sci-Fi,Thriller
the-gleaners-i	Documentary
in-the-bedroom	Crime,Drama
ali	Biography,Drama,Sport
hedwig-and-the-angry-inch	Comedy,Drama,Music
werckmeister-harmonies	Drama,Mystery
the-death-of-stalin	Documentary
choke	Documentary,Sport
cq	Comedy,Drama,Sci-Fi
dog-eat-dog	Comedy,Drama
the-piano-teacher	Drama
road-to-perdition	Crime,Drama,Thriller
about-schmidt	Comedy,Drama
panic-room	Crime,Drama,Thriller
session-9	Horror,Mystery
the-walker	Short
dagon	Fantasy,Horror,Mystery
lemonade	Short
the-mothman-prophecies	Drama,Horror,Mystery
one-hour-photo	Drama,Thriller
the-royal-tenenbaums	Comedy,Drama
kill-bill-vol-1	Action,Crime,Thriller
adaptation	Comedy,Drama
confessions-of-a-dangerous-mind	Biography,Comedy,Crime
black-swan	Comedy,Drama
the-congress	Documentary
punch-drunk-love	Comedy,Drama,Romance
24-hour-party-people	Biography,Comedy,Drama
bad-education	Crime,Drama
dogville	Crime,Drama
spider	Drama,Mystery,Thriller
the-good-girl	Drama,Romance
the-banishment	Drama,Romance
the-savages	Comedy
bubba-ho-tep	Comedy,Fantasy,Horror
love-liza	Comedy,Drama
raw	Adult
nebraska	Drama
signs	Drama,Mystery,Sci-Fi
talk-to-her	Drama,Mystery,Romance
28-days-later	Drama,Horror,Sci-Fi
jarhead	Adult
the-void	Sci-Fi,Thriller
a-wrinkle-in-time	Adventure,Family,Fantasy
irreversible	Crime,Drama,Mystery
dracula-pages-from-a-virgins-diary	Horror,Musical
let-me-in	Short
the-empire-strikes-back	Action,Adventure,Sci-Fi
harry-potter-and-the-chamber-of-secrets	Adventure,Family,Fantasy
vendredi-soir	Drama,Romance
rampart	Action
the-texas-chainsaw-massacre	Action,Horror
far-from-heaven	Drama
auto-focus	Biography,Crime,Drama
all-the-real-girls	Drama,Romance
morvern-callar	Drama
paris-je-taime	Documentary
gerry	Adventure,Drama,Mystery
harry-potter-and-the-prisoner-of-azkaban	Adventure,Family,Fantasy
harry-potter-and-the-philosophers-stone	Action,Adventure,Fantasy
leave-no-trace	Action,Drama,Thriller
time-of-the-wolf	Drama
25th-hour	Drama
sympathy-for-mr-vengeance	Action,Drama,Thriller
spider-man-2	Action,Adventure,Sci-Fi
i-am-love	Romance
blissfully-yours	Drama,Romance
russian-ark	Drama,Fantasy,History
resident-evil-apocalypse	Action,Horror,Sci-Fi
big-fish	Adventure,Drama,Fantasy
japon	Drama
god-bless-america	Short
coraline	Animation,Drama,Fantasy
ondine	Drama,Fantasy,Romance
high-life	Comedy,Short
seabiscuit	Drama,History,Sport
the-brown-bunny	Drama
girl-with-a-pearl-earring	Biography,Drama,Romance
lost-in-translation	Drama
the-passion-of-the-christ	Drama
eternal-sunshine-of-the-spotless-mind	Drama,Romance,Sci-Fi
haute-tension	Horror
the-station-agent	Comedy,Drama
dear-wendy	Comedy,Crime,Drama
paddington	Animation,Family
a-very-long-engagement	Drama,Mystery,Romance
code-46	Drama,Romance,Sci-Fi
uzak	Drama
cowards-bend-the-knee	Drama,Romance
closer	Documentary,Short
the-science-of-sleep	Comedy,Drama,Fantasy
i-heart-huckabees	Comedy
the-imitation-game	Comedy,Drama
walk-the-line	Biography,Drama,Music
wildlife	Short
notre-musique	Drama
inglourious-basterds	Adventure,Drama,War
the-machinist	Drama,Thriller
the-life-aquatic-with-steve-zissou	Action,Adventure,Comedy
the-grey	Drama
oldboy	Action,Drama,Mystery
the-assassination-of-richard-nixon	Biography,Crime,Drama
a-tale-of-two-sisters	Drama,Horror,Thriller
syriana	Drama,Thriller
shaun-of-the-dead	Comedy,Horror
somewhere	Romance
brick-lane	Comedy,Drama,Short
the-saddest-music-in-the-world	Comedy,Musical
the-squid-and-the-whale	Comedy,Drama
charlie-and-the-chocolate-factory	Adventure,Comedy,Family
room	Drama,Short
the-heart-is-deceitful-above-all-things	Drama
im-not-there	Biography,Drama,Music
collateral	Crime,Drama,Thriller
frank	Action,Short
before-sunset	Drama,Thriller
mysterious-skin	Drama
patagonia	Fantasy,Romance,Short
stay	Drama,Mystery,Thriller
batman-begins	Action,Adventure
napoleon-dynamite	Comedy
a-serious-man	Comedy,Drama,Short
sideways	Comedy,Drama,Romance
layer-cake	Action,Crime,Drama
mean-creek	Crime,Drama
kill-bill-vol-2	Action,Crime,Thriller
capote	Biography,Crime,Drama
moon	Short
carol	Fantasy,Short
tropical-malady	Drama,Fantasy,Romance
synecdoche-new-york	Comedy,Drama
unbroken	Drama,Short
house-of-flying-daggers	Action,Adventure,Drama
where-the-wild-things-are	Adventure,Drama,Family
battle-in-heaven	Crime,Drama
isolation	Drama,Short
seed-of-chucky	Comedy,Fantasy,Horror
the-black-dahlia	Crime,Drama,Mystery
brokeback-mountain	Drama,Romance
urge	Comedy,Short
black-book	Drama,Thriller,War
30-days-of-night	Action,Horror,Thriller
brick	Action,Crime,Drama
the-devils-rejects	Horror
get-out	Documentary
the-diving-bell-and-the-butterfly	Biography,Drama
the-new-world	Biography,Drama,History
everything-is-illuminated	Comedy,Drama
little-children	Drama,Romance
the-lives-of-others	Drama,Mystery,Thriller
a-scanner-darkly	Animation,Crime,Drama
the-departed	Crime,Drama,Thriller
munich	Biography,Crime,Drama
watchmen	Action,Drama,Mystery
tideland	Drama,Fantasy,Horror
breakfast-on-pluto	Comedy,Drama
hellboy-ii-the-golden-army	Action,Adventure,Fantasy
9-songs	Drama,Music,Romance
broken-flowers	Comedy,Drama,Mystery
changeling	Drama
the-taste-of-tea	Comedy,Fantasy
me-and-you-and-everyone-we-know	Comedy,Drama
kamikaze-girls	Comedy
junebug	Comedy,Drama
the-three-burials-of-melquiades-estrada	Adventure,Crime,Drama
a-prairie-home-companion	Comedy,Drama,Music
the-curious-case-of-benjamin-button	Drama,Fantasy,Romance
fur-an-imaginary-portrait-of-diane-arbus	Biography,Drama,Romance
rampo-noir	Fantasy,Horror
hot-fuzz	Action,Comedy,Mystery
resident-evil-extinction	Action,Horror,Sci-Fi
fantastic-mr-fox	Adventure,Animation,Comedy
good-night-and-good-luck	Biography,Drama,History
v-for-vendetta	Action,Drama,Sci-Fi
the-descent	Adventure,Horror,Thriller
brand-upon-the-brain	Comedy,Drama,Fantasy
the-assassination-of-jesse-james-by-the-coward-robert-ford	Biography,Crime,Drama
across-the-universe	Drama,Fantasy,History
scott-pilgrim-vs-the-world	Action,Comedy,Fantasy
ida	Short
dominion-prequel-to-the-exorcist	Drama,Horror,Thriller
punisher-war-zone	Action,Crime,Drama
the-reader	Drama,Short
lady-vengeance	Crime,Drama,Thriller
the-good-german	Drama,Mystery,Romance
bubble	Crime,Drama,Mystery
pans-labyrinth	Drama,Fantasy,War
nacho-libre	Comedy,Family,Sport
captain-america-the-first-avenger	Action,Adventure,Sci-Fi
sin-city-a-dame-to-kill-for	Action,Crime,Thriller
kill-your-darlings	Short
the-wind-that-shakes-the-barley	Drama,War
rescue-dawn	Action,Biography,Drama
the-orphanage	Drama,Horror,Mystery
michael-clayton	Crime,Drama,Mystery
old-joy	Drama
the-dark-knight	Action,Crime,Drama
there-will-be-blood	Drama
ex-machina	Drama,Mystery,Sci-Fi
red-road	Drama,Mystery,Thriller
angel-a	Comedy,Drama,Fantasy
mister-lonely	Comedy,Drama
no-country-for-old-men	Crime,Drama,Thriller
syndromes-and-a-century	Drama
ant-man	Action,Adventure,Comedy
adam-resurrected	Drama,War
timecrimes	Horror,Mystery,Sci-Fi
the-prestige	Drama,Mystery,Sci-Fi
wind-chill	Drama,Horror,Thriller
green-room	Short
away-from-her	Drama
boarding-gate	Drama,Thriller
eagle-vs-shark	Comedy,Romance
oceans-thirteen	Crime,Thriller
lost-river	Adventure,Western
the-fourth-man	Crime,Drama,Mystery
damsel	Fantasy,Horror,Mystery
selfless	Action,Drama,Fantasy
brooklyn	Comedy,Crime,Drama
lady-bird	Comedy
thor	Comedy
howl	Drama
our-day-will-come	Drama,Romance
nerve	Adventure,Drama,Sci-Fi
upgrade	Adventure,Fantasy,Horror
the-purge	Adventure,Drama,Mystery
the-sacrament	Drama
while-were-young	Comedy,Drama,Music
beginners	Comedy,Drama
the-innkeepers	Comedy
the-little-hours	Comedy,Drama
i-think-were-alone-now	Comedy
year-of-the-dog	Action,Adventure,Crime
a-quiet-place	Action,Crime,Drama
clan-of-the-cave-bear	Comedy
ballast	Drama
the-look-of-love	Comedy
a-ghost-story	Action,Adventure,Crime
8-12	Comedy
the-martian	Drama,Fantasy,Horror
stoker	Adventure,Fantasy,Sci-Fi
transcendence	Action,Drama,Fantasy
margot-at-the-wedding	Comedy,Drama
interstellar	Drama,Sci-Fi,Short
death-note	Crime,Drama,Fantasy
into-the-wild	Adventure,Biography,Drama
nightcrawler	Action,Animation,Family
my-blueberry-nights	Drama,Romance
american-gangster	Biography,Crime,Drama
eastern-promises	Action,Crime,Drama
another-year	Drama
smiley-face	Comedy
genova	Drama,Mystery,Romance
sakuran	Drama,History
be-kind-rewind	Comedy
its-kind-of-a-funny-story	Comedy,Drama,Romance
lars-and-the-real-girl	Comedy,Drama,Romance
the-midnight-meat-train	Horror,Mystery
bright-star	Biography,Drama,Romance
the-danish-girl	Biography,Drama,Romance
kick-ass	Documentary
honeydripper	Crime,Drama,History
visioneers	Comedy,Drama,Sci-Fi
the-darjeeling-limited	Adventure,Comedy,Drama
silent-light	Drama,Romance
the-brothers-bloom	Action,Adventure,Comedy
valhalla-rising	Adventure,Drama,Fantasy
trick-r-treat	Comedy,Horror
the-editor	Comedy,Family
burn-after-reading	Comedy,Crime,Drama
la-la-land	Comedy,Short
love-mercy	Biography,Drama,Music
doctor-strange	Action,Animation,Fantasy
pineapple-express	Action,Comedy,Crime
broken-embraces	Drama,Romance,Thriller
assassins-creed	Action,Adventure,Crime
source-code	Action,Drama,Mystery
repo-the-genetic-opera	Musical,Short
hermitage	Drama,Romance,Short
shotgun-stories	Drama,Thriller
revolutionary-road	Drama,Romance
everlasting-moments	Drama,History
tetro	Drama
the-favourite	Comedy
hell-or-high-water	Action,Crime,Drama
the-east	Documentary,Short
solo-a-star-wars-story	Comedy,Talk-Show
spider-man-into-the-spider-verse	Comedy
captain-america-civil-war	Documentary
slumdog-millionaire	Drama,Romance
her	Music
dredd	Adult
super-8	Sci-Fi,Short
spider-man-homecoming	Documentary
shoplifters	Documentary
halloween-2	Horror,Short
mad-max-fury-road	Comedy
mulholland-drive	Drama,Short
logan	Comedy
a-girl-walks-home-alone-at-night	Comedy,Fantasy,Horror
splice	Drama,Horror,Sci-Fi
gone-girl	Drama,Fantasy,Horror
500-days-of-summer	Comedy,Drama,Romance
the-scouting-book-for-boys	Drama,Thriller
avengers-infinity-war	Talk-Show
house-by-the-cemetery	Horror
pontypool	Comedy,Horror,Talk-Show
i-trapped-the-devil	Comedy,Talk-Show
death-proof	Thriller
vinyan	Drama,Horror,Thriller
john-wick	Talk-Show
the-descendants	Comedy,Drama
entertainment	Talk-Show
your-highness	Action,Comedy,Fantasy
silver-linings-playbook	Comedy,Drama,Romance
alien-3	Comedy
the-imaginarium-of-doctor-parnassus	Adventure,Comedy,Fantasy
guardians-of-the-galaxy	Documentary
let-the-sunshine-in	Adventure,Drama,Short
adult-world	Comedy,Drama
the-burning-plain	Crime,Drama,Romance
land-ho	Animation,Comedy,Drama
the-neon-demon	Comedy,Horror,Talk-Show
skyfall	Action,Adventure,Thriller
star-wars-the-force-awakens	Comedy
127-hours	Comedy
the-hunger-games	Comedy
evil-dead	Documentary
adventureland	Comedy,Drama,Romance
my-winnipeg	Comedy,Documentary,Drama
halloween-2018	Comedy
bad-lieutenant-port-of-call-new-orleans	Crime,Drama
avengers-age-of-ultron	Comedy,Talk-Show
deadpool	Comedy,Talk-Show
batman-v-superman-dawn-of-justice	Comedy,Talk-Show
star-trek-beyond	Comedy,Talk-Show
kong-skull-island	Comedy,Talk-Show
guardians-of-the-galaxy-vol-2	Comedy,Talk-Show
35-shots-of-rum	Drama
foxcatcher	Biography,Drama,Sport
star-wars-the-last-jedi	Comedy
christopher-robin	Comedy
the-girlfriend-experience	Drama
looper	Talk-Show
blindspotting	Drama
american-hustle	Crime,Drama
blue-valentine	Drama,Romance
it-follows	Horror
free-state-of-jones	Action,Biography,Drama
drag-me-to-hell	Horror,Thriller
cold-souls	Comedy,Drama
the-beaches-of-agnes	Biography,Documentary
shutter-island	Mystery,Thriller
jennifers-body	Comedy,Horror
the-girl-with-the-dragon-tattoo	Crime,Drama,Mystery
alleluia	Action,Comedy,Crime
the-limits-of-control	Crime,Drama,Mystery
white-material	Drama,War
district-9	Action,Sci-Fi,Thriller
let-the-right-one-in	Drama,Horror,Romance
the-white-ribbon	Drama,History,Mystery
wendy-and-lucy	Drama
gentlemen-broncos	Adventure,Comedy,Sci-Fi
biutiful	Drama,Romance
somers-town	Comedy,Drama
bronson	Action,Biography,Crime
the-extraordinary-adventures-of-adele-blanc-sec	Action,Adventure,Fantasy
10-cloverfield-lane	Drama,Horror,Mystery
antoine-and-colette	Comedy,Drama,Romance
the-skin-i-live-in	Drama,Horror,Thriller
enter-the-void	Drama,Fantasy
observe-and-report	Comedy,Crime,Drama
gran-torino	Drama
out-of-the-furnace	Action,Crime,Drama
moneyball	Biography,Drama,Sport
the-lost-city-of-z	Biography,Drama,History
the-worlds-end	Action,Comedy,Sci-Fi
womb	Drama,Romance,Sci-Fi
resident-evil-afterlife	Action,Adventure,Horror
the-damned-united	Biography,Drama,Sport
iron-man-2	Action,Adventure,Sci-Fi
fish-tank	Drama
my-son-my-son-what-have-ye-done	Drama,Thriller
greenberg	Comedy,Drama,Romance
sidewalls	Comedy,Drama
mystery-team	Comedy,Crime,Mystery
we-need-to-talk-about-kevin	Drama,Mystery,Thriller
looking-for-eric	Comedy,Drama,Fantasy
bellflower	Action,Drama,Romance
bunny-and-the-bull	Comedy,Drama
the-cabin-in-the-woods	Horror
nowhere-boy	Biography,Drama,Music
the-social-network	Biography,Drama
behind-the-candelabra	Biography,Drama,Music
short-term-12	Drama,Short
iron-man-3	Action,Adventure,Sci-Fi
magic-mike	Reality-TV
the-turin-horse	Drama
gangster-squad	Action,Crime,Drama
one-hundred-mornings	Drama
humpday	Comedy,Drama,Romance
the-revenant	Comedy,Fantasy,Horror
the-dark-knight-rises	Action,Thriller
another-earth	Documentary,History
van-diemens-land	Biography,Drama,History
beasts-of-no-nation	Drama,War
american-honey	Drama,Short
cloud-atlas	Action,Drama,Mystery
apostle	Action,Drama,Sci-Fi
inception	Action,Adventure,Sci-Fi
dogtooth	Drama,Thriller
paradise-love	Drama
star-trek-into-darkness	Action,Adventure,Sci-Fi
the-hangover-part-ii	Comedy
i-killed-my-mother-jai-tue-ma-mere	Drama,Romance
amer	Horror,Thriller
martha-marcy-may-marlene	Drama,Mystery,Thriller
the-conjuring	Horror,Mystery,Thriller
the-grandmaster	Action,Biography,Drama
macgruber	Action,Comedy,Romance
cedar-rapids	Comedy
tamara-drewe	Comedy,Drama,Romance
trash-humpers	Comedy,Drama,Horror
down-terrace	Crime,Drama
the-kings-speech	Biography,Drama,History
meeks-cutoff	Drama,Western
byzantium	Drama,Fantasy,Horror
almayers-folly	Drama
beyond-the-black-rainbow	Horror,Sci-Fi,Thriller
bullhead	Drama,Short
little-birds	Documentary
essential-killing	Thriller,War
a-dangerous-method	Biography,Drama,Romance
the-skeleton-twins	Comedy,Drama,Romance
this-movie-is-broken	Drama,Music,Romance
i-saw-the-devil	Action,Crime,Drama
take-this-waltz	Comedy,Drama
to-the-wonder	Drama,Romance
pawn-sacrifice	Biography,Drama,Sport
heartbeats-les-amours-imaginaires	Drama,Romance
only-god-forgives	Action,Crime,Drama
margin-call	Drama,Thriller
a-horrible-way-to-die	Drama,Horror,Thriller
jupiter-ascending	Action,Adventure,Sci-Fi
jauja	Drama,Short
hobo-with-a-shotgun	Action,Comedy,Horror
laurence-anyways	Drama,Romance
the-perks-of-being-a-wallflower	Drama,Romance
pacific-rim	Action,Adventure,Sci-Fi
take-shelter	Drama,Horror,Thriller
snowtown	Biography,Crime,Drama
attenberg	Drama
i-melt-with-you	Drama
casa-de-mi-padre	Comedy,Western
the-last-days-on-mars	Adventure,Horror,Sci-Fi
message-from-the-king	Action,Thriller
triple-9	Crime,Thriller
only-lovers-left-alive	Comedy,Drama,Fantasy
killer-joe	Crime,Drama,Thriller
snow-white-and-the-huntsman	Action,Adventure,Drama
your-sisters-sister	Comedy,Drama
moonrise-kingdom	Comedy,Drama,Romance
sound-of-my-voice	Drama,Mystery,Sci-Fi
post-tenebras-lux	Drama
the-colour-of-money	Game-Show
killing-them-softly	Crime,Drama,Thriller
kill-list	Crime,Drama,Horror
simon-killer	Drama,Thriller
zero-dark-thirty	Drama,Thriller
inherent-vice	Comedy,Crime,Drama
the-place-beyond-the-pines	Crime,Drama,Thriller
steve-jobs	Documentary
chappie	Action,Crime,Drama
berberian-sound-studio	Drama,Horror,Thriller
ruby-sparks	Comedy,Drama,Fantasy
the-bride-of-frankenstein	Comedy,Short
captain-america-the-winter-soldier	Action,Adventure,Sci-Fi
django-unchained	Drama,Western
resident-evil-retribution	Action,Horror,Sci-Fi
blade-runner-2049	Action,Drama,Mystery
alps	Drama
the-legend-of-kaspar-hauser	Drama,Mystery
the-bling-ring	Drama
the-abcs-of-death	Comedy,Horror
borgman	Drama,Horror,Mystery
american-mary	Drama,Horror
kiss-of-the-damned	Drama,Horror,Romance
compliance	Biography,Crime,Drama
the-two-faces-of-january	Romance,Thriller
thor-the-dark-world	Action,Adventure,Fantasy
the-sea-of-trees	Drama
computer-chess	Comedy
return-of-the-jedi	Comedy
sightseers	Adventure,Comedy,Crime
12-years-a-slave	Biography,Drama,History
laggies	Comedy,Drama,Romance
inside-llewyn-davis	Comedy,Drama,Music
a-glimpse-inside-the-mind-of-charles-swan-iii	Comedy
rust-and-bone	Drama,Romance
the-endless	Crime,Drama,Short
song-to-song	Drama,Music,Romance
the-lobster	Animation
populaire	Comedy,Romance,Sport
holy-motors	Drama,Fantasy
upstream-color	Drama,Sci-Fi
what-richard-did	Drama
new-nightmare	Documentary
antiviral	Horror,Sci-Fi,Thriller
knight-of-cups	Drama,Romance
spring-breakers	Crime,Drama
here-comes-the-devil	Horror,Thriller
ginger-rosa	Drama
fleshblood	Crime,Short,Thriller
beasts-of-the-southern-wild	Adventure,Drama,Fantasy
the-devils-doorway	Adventure,Animation,Family
renoir	Biography,Drama,History
maps-to-the-stars	Comedy,Drama
prince-avalanche	Comedy,Drama
wildlike	Adventure,Drama,Thriller
vanishing-waves	Romance,Sci-Fi,Thriller
interview-with-the-vampire	Comedy
curse-of-chucky	Horror,Thriller
white-bird-in-a-blizzard	Drama,Mystery,Thriller
im-so-excited	Comedy
magic-mike-xxl	Comedy,Drama,Music
museum-hours	Drama
the-grand-budapest-hotel	Adventure,Comedy,Crime
the-canyons	Drama,Thriller
wonderstruck	Drama,Short
the-babadook	Drama,Horror
hard-to-be-a-god	Drama,Sci-Fi
the-zero-theorem	Comedy,Drama,Fantasy
fruitvale-station	Biography,Drama,Romance
frances-ha	Comedy,Drama,Romance
mississippi-grind	Comedy,Drama
the-great-beauty	Drama
blue-ruin	Crime,Drama,Thriller
we-are-the-best	Drama,Music
paradise-faith	Drama
paradise-hope	Drama
a-field-in-england	Drama,History,Horror
aint-them-bodies-saints	Crime,Drama,Romance
a-quiet-passion	Biography,Drama
predestination	Action,Drama,Mystery
the-homesman	Drama,Western
anomalisa	Animation,Comedy,Drama
dom-hemingway	Comedy,Crime,Drama
atomic-blonde	Action,Mystery,Thriller
tom-at-the-farm	Drama,Mystery,Thriller
clouds-of-sils-maria	Drama
mr-turner	Biography,Drama,History
palo-alto	Drama
nocturama	Drama,Short
american-animals	Family
lasting-nieulotne	Drama,Romance
crimson-peak	Drama,Fantasy,Horror
the-duke-of-burgundy	Drama,Mystery,Romance
resident-evil-the-final-chapter	Action,Horror,Sci-Fi
catch-me-daddy	Drama,Thriller
locke	Drama
blackhat	Action,Crime,Thriller
the-old-man-the-gun	Biography,Comedy,Crime
stranger-by-the-lake	Drama,Romance,Thriller
lords-of-salem	Talk-Show
wish-i-was-here	Comedy,Drama
mistress-america	Comedy,Drama
i-origins	Drama,Romance,Sci-Fi
gods-pocket	Crime,Drama
a-most-violent-year	Action,Crime,Drama
the-face-of-an-angel	Crime,Drama
the-purge-anarchy	Action,Horror,Sci-Fi
da-sweet-blood-of-jesus	Comedy,Romance,Thriller
jimmys-hall	Biography,Drama,History
cam	Mystery,Short
the-diary-of-a-teenage-girl	Comedy,Drama,Romance
slow-west	Action,Adventure,Western
black-47	Action,Drama
kumiko-the-treasure-hunter	Drama
tale-of-tales	Drama,Fantasy,Horror
cult-of-chucky	Comedy,Fantasy,Horror
the-autopsy-of-jane-doe	Horror,Mystery,Thriller
a-monster-calls	Animation,Drama,Fantasy
the-hateful-eight	Crime,Drama,Mystery
thor-ragnarok	Action,Adventure,Comedy
the-disaster-artist	Biography,Comedy,Drama
meadowland	Drama
45-years	Drama,Romance
blue-jay	Action,Drama,Thriller
fall-of-the-house-of-usher	Drama
turbo-kid	Action,Adventure,Comedy
experimenter	Biography,Drama,History
geralds-game	Drama,Horror,Thriller
the-nice-guys	Action,Comedy,Crime
cop-car	Crime,Thriller
baby-driver	Action,Crime,Drama
dont-breathe	Documentary
adam-greens-aladdin	Adventure,Comedy,Drama
queen-of-earth	Drama,Mystery,Thriller
swiss-army-man	Comedy,Drama,Fantasy
the-shallows	Drama,Horror,Thriller
cries-and-whispers	Comedy,Drama,Mystery
the-purge-election-year	Action,Horror,Sci-Fi
wiener-dog	Comedy,Drama
free-fire	Action,Comedy,Crime
a-date-for-mad-mary	Comedy,Drama,Romance
kubo-and-the-two-strings	Action,Adventure,Animation
i-am-not-a-serial-killer	Drama,Horror,Thriller
the-bad-batch	Drama,Horror,Romance
the-greasy-strangler	Comedy,Horror
beach-rats	Reality-TV
officer-downe	Action,Comedy,Sci-Fi
chi-raq	Comedy,Crime,Drama
can-you-ever-forgive-me	Biography,Comedy,Crime
hunt-for-the-wilderpeople	Adventure,Comedy,Drama
terminator-2-judgement-day	Comedy
mindhorn	Comedy
good-time	Crime,Drama,Thriller
the-whispering-star	Sci-Fi
hold-the-dark	Drama,Horror,Mystery
i-am-the-pretty-thing-that-lives-in-the-house	Horror,Mystery,Thriller
super-dark-times	Crime,Drama,Horror
kate-plays-christine	Biography,Documentary,Drama
lean-on-pete	Adventure,Drama
the-big-sick	Comedy,Drama,Romance
mid90s	Comedy,Drama
the-florida-project	Drama
back-to-the-future-ii	Comedy
brawl-in-cell-block-99	Action,Crime,Drama
sorry-to-bother-you	Comedy,Fantasy,Sci-Fi
the-killing-of-a-sacred-deer	Drama,Mystery,Thriller
call-me-by-your-name	Drama,Romance
hereditary	Drama,Short
you-were-never-really-here	Crime,Drama,Mystery
phantom-thread	Drama,Romance
brigsby-bear	Comedy,Drama
let-the-corpses-tan	Thriller
ghostbusters-2	Comedy
13th	Crime,Documentary,News
ingrid-goes-west	Comedy,Drama
first-reformed	Drama,Mystery,Thriller
madelines-madeline	Drama,Mystery,Thriller
assassination-nation	Action,Comedy,Crime
the-miseducation-of-cameron-post	Drama
the-ballad-of-buster-scruggs	Comedy,Drama,Musical
the-corpse-bride	Horror
bad-times-at-the-el-royale	Crime,Drama,Mystery
eighth-grade	Comedy,Drama
satans-slaves	Drama,Horror,Mystery
if-beale-street-could-talk	Drama,Romance
unsane	Drama,Horror,Mystery
hearts-beat-loud	Comedy,Drama,Music
blackkklansman	Biography,Crime,Drama
final-girls	Horror
the-perfection	Drama,Horror,Thriller
relaxer	Comedy,Fantasy
high-flying-bird	Drama,Sport
guava-island	Comedy,Drama,Music
fellini-satyricon	Comedy
